взрослый=adult
возраст=age
малыш=baby
рождение=birth
мальчик=boy
ребенок=child
детство=childhood
девочка=girl
человек=human
ребенок=kid
жизнь=life
мужчина=man
имя=name
люди=people
человек=person
личность=personality
фамилия=surname
подросток=teenager
женщина=woman
молодость=youth
он=he
я=I
оно=it
мой=my
наш=our
она=she
они=they
мы=we
рука=arm
спина=back
живот=belly
кровь=blood
тело=body
кость=bone
мозг=brain
щека=cheek
грудь=chest
подбородок=chin
ухо=ear
локоть=elbow
глаз=eye
бровь=eyebrow
ресница=eyelash
лицо=face
палец=finger
кулак=fist
ступня=foot
лоб=forehead
волосы=hair
ладонь=hand
сердце=heart
пятка=heel
бедро=hip
челюсть=jaw
почка=kidney
колено=knee
нога=leg
губы=lips
мизинец=littlefinger
печень=liver
легкое=lung
рот=mouth
мышца=muscle
ноготь=nail
шея=neck
нерв=nerve
нос=nose
ладонь=palm
ребро=rib
скелет=skelen
кожа=skin
череп=skull
желудок=smach
горло=throat
язык=ngue
зуб=oth
запястье=wrist
быть=be
дышать=breathe
слышать=hear
держать=hold
лежать=lie
смотреть=look
видеть=see
сидеть=sit
говорить=speak
трогать=uch
ходить=walk
привлекательный=attractive
лысый=bald
борода=beard
красивый=beautiful
красота=beauty
белокурый=blond
обычный=common
кудрявый=curly
милый=cute
темный=dark
белокурый=fair
толстый=fat
фигура=figure
румянец=flush
веснушки=freckles
рыжий=ginger
рост=height
усы=moustache
овальный=oval
бледный=pale
пухлый=plump
круглый=round
короткий=short
квадратный=square
прямой=straight
высокий=tall
худой=thin
уродливый=ugly
волнистый=wavy
вес=weight